3,6,4,3,3,1,6,6,9,2,1,10,10,10,7,2,3,7,6,2,8,0,7,3,5,9
6,1,0,7,3,3,4,0,10,3,6,4,10,9,9,1,2,8,2,6,10,0,2,3,0,1
0,9,5,6,0,6,8,4,9,4,2,4,10,2,1,3,5,7,7,9,5,2,6,8,3,5
0,7,2,4,2,2,10,1,0,2,9,2,9,5,10,7,4,10,1,10,3,7,10,9,2,0
2,7,7,10,7,1,6,5,0,7,4,9,4,6,7,4,8,6,1,3,10,6,9,4,4,3
9,8,2,2,7,9,3,2,8,5,10,2,8,7,2,5,7,9,2,10,0,8,9,9,10,8
8,1,4,9,3,4,10,6,3,6,6,7,9,5,4,8,7,4,5,5,10,2,2,7,2,4
3,0,6,1,4,10,7,0,1,7,10,4,0,5,2,0,9,9,6,3,3,7,9,10,3,6
8,8,4,3,10,4,5,0,10,10,8,8,5,5,3,5,8,4,5,7,6,2,9,4,6,4
10,4,5,1,4,7,4,10,6,2,6,9,1,4,9,9,10,8,5,7,4,6,4,1,10,9
7,9,3,7,1,2,0,5,8,0,5,6,9,2,8,8,9,2,9,2,0,7,7,4,0,9
3,3,10,6,3,3,9,5,10,4,5,1,1,3,8,7,4,10,6,4,10,7,3,9,8,10
8,8,2,3,5,10,0,9,10,7,2,7,1,5,3,5,3,9,8,9,0,0,10,9,3,7
0,8,9,6,8,4,1,3,5,6,3,10,4,3,0,6,4,0,0,1,6,4,2,0,7,2
6,0,4,7,3,6,10,1,7,9,6,6,6,3,4,2,6,8,3,8,10,7,1,6,5,3
5,0,0,0,5,10,4,10,1,6,1,5,1,3,0,0,6,1,3,4,10,6,1,7,8,0
8,9,8,7,5,2,5,10,4,3,2,7,2,10,0,8,3,0,6,8,9,10,10,1,10,5
3,4,2,10,6,2,2,9,3,10,4,2,9,1,7,8,7,5,3,7,8,0,6,4,6,0
2,4,4,8,7,9,0,7,2,0,1,9,2,9,4,5,9,1,6,5,7,3,4,5,2,5
0,2,6,10,9,1,8,0,8,3,7,1,3,3,3,2,6,0,4,6,7,0,2,10,3,3
8,6,2,0,2,8,9,0,4,8,5,5,5,4,9,10,1,2,8,4,9,10,0,10,7,5
0,2,0,1,0,3,0,5,4,8,10,5,8,5,6,7,5,9,0,2,3,9,9,8,2,2
2,3,2,9,7,6,4,4,5,0,10,4,2,5,0,1,4,9,4,10,2,6,4,9,4,5
2,2,6,6,0,3,2,1,10,8,10,1,9,5,2,10,9,2,0,9,1,2,10,5,0,8
1,6,5,2,6,6,7,9,4,2,3,8,7,3,7,8,5,6,7,0,4,3,10,4,8,1
7,6,4,2,7,10,6,5,8,10,10,10,5,8,2,9,1,2,4,1,5,6,1,10,1,4
